bbc.mobile.news.ww	com.mobile.MainActivity
bitpit.launcher	.ui.HomeActivity
ch.protonmail.android	.MainActivity
chipolo.net.v3	net.chipolo.app.ui.main.MainActivity
com.Splitwise.SplitwiseMobile	.views.SplitwiseSplashScreen
com.aaa.android.discounts	.MainActivity
com.abc.abcnews	com.disney.bootstrap.activity.bootstrap.BootstrapActivity
com.adobe.lrmobile	.StorageCheckActivity
com.adobe.reader	.AdobeReader
com.alphainventor.filemanager	.activity.MainActivity
com.amazon.avod.thirdpartyclient	com.amazon.avod.client.activity.SplashScreenActivity
com.amazon.dee.app	.Launcher
com.amazon.kindle	.UpgradePage
com.amazon.mShop.android.shopping	com.amazon.mShop.home.HomeActivity
com.americanexpress.android.acctsvcs.us	.firstuse.StartupActivity
com.americanexpress.android.acctsvcs.us	com.qualtrics.digital.QualtricsNotificationManager
com.android.chrome	com.google.android.apps.chrome.IntentDispatcher
com.android.vending	com.google.android.finsky.setupui.VpaSelectionOptionalStepActivity
com.audible.application	androidx.test.core.app.InstrumentationActivityInvoker$BootstrapActivity
com.azure.authenticator	.ui.LaunchActivity
com.basiletti.gino.offlinenotepad	.ui.main.DashboardActivity
com.bose.bosemusic	com.bose.madrid.SplashScreenActivity
com.britbox.us	.MainActivity
com.cbs.app	com.paramount.android.pplus.features.splash.mobile.integration.SplashActivity
com.chase.sig.android	.activity.SplashActivity
com.chess	.splash.SplashActivity
com.citi.citimobile	com.citi.mobile.pt3.GlobalPhoneActivity
com.cnn.mobile.android.phone	.features.splash.SplashActivity
com.cookunity.android.app	.ui.activity.InitActivity
com.costco.app.android	.ui.main.MainActivity
com.curiosity.curiositystream	.MainActivity
com.dashlane	.ui.activities.SplashScreenActivity
com.daugherty.nws_remastered	.MainActivity
com.delta.mobile.android	.SplashScreen
com.delta.mobile.android	com.qualtrics.digital.QualtricsNotificationManager
com.digitalpharmacist.rxpharmacy	.SplashActivity
com.discord	.main.MainDefault
com.disney.disneyplus	com.bamtechmedia.dominguez.main.MainActivity
com.dropbox.android	.activity.DropboxBrowser
com.etatransit	.activity.SplashActivity
com.etekcity.vesyncplatform	.presentation.ui.activities.LaunchActivity
com.example.composetest	.MainActivity
com.example.gemini_asset_manager	.MainActivity
com.example.gemini_example_app	.MainActivity
com.example.roomdemo	.MainActivity
com.example.textfielddemo	.MainActivity
com.expedia.bookings	.activity.SearchActivity
com.expedia.bookings	com.qualtrics.digital.QualtricsNotificationManager
com.fedex.ida.android	.views.core.FedExHOME
com.fedex.ida.android	com.qualtrics.digital.QualtricsNotificationManager
com.fitbit.FitbitMobile	com.fitbit.FirstActivity
com.geico.mobile	.android.ace.geicoapppresentation.splash.mvvm.view.AceSplashActivity
com.github.android	.main.MainActivity
com.google.android.GoogleCamera	com.android.camera.CameraLauncher
com.google.android.accessibility.soundamplifier	.ui.SoundAmplifierSettingActivity
com.google.android.accessibility.switchaccess	.LaunchActivity
com.google.android.apps.access.wifi.consumer	.app.MainActivity
com.google.android.apps.accessibility.magnifier	.home.HomeActivity
com.google.android.apps.accessibility.voiceaccess	.activities.JustSpeakPreferencesActivity
com.google.android.apps.adm	.activities.MainActivity
com.google.android.apps.authenticator2	.main.MainActivity
com.google.android.apps.bard	.shellapp.BardEntryPointActivity
com.google.android.apps.books	.app.BooksActivity
com.google.android.apps.chromecast.app	.DiscoveryActivity
com.google.android.apps.cloudconsole	.common.ExternalMainContainerActivity
com.google.android.apps.docs.editors.docs	com.google.android.apps.docs.app.NewMainProxyActivity
com.google.android.apps.docs.editors.sheets	com.google.android.apps.docs.app.NewMainProxyActivity
com.google.android.apps.docs.editors.slides	com.google.android.apps.docs.app.NewMainProxyActivity
com.google.android.apps.docs	.app.NewMainProxyActivity
com.google.android.apps.dynamite	.startup.StartUpActivity
com.google.android.apps.healthdata	.SettingsActivity1
com.google.android.apps.magazines	com.google.apps.dots.android.app.activity.CurrentsStartActivity
com.google.android.apps.maps	com.google.android.maps.MapsActivity
com.google.android.apps.messaging	.ui.ConversationListActivity
com.google.android.apps.nbu.files	.home.HomeActivity
com.google.android.apps.photos	.home.HomeActivity
com.google.android.apps.photos	.home.HomeActivity
com.google.android.apps.photos	.home.HomeActivity
com.google.android.apps.pixel.agent	.app.ui.browser.BrowserActivity
com.google.android.apps.pixel.creativeassistant	com.google.android.apps.pixel.merlin.tiktok.app.MainActivity
com.google.android.apps.pixel.health	.thermometer.ThermometerHomeActivity
com.google.android.apps.pixel.relationships	.advancedcontactview.ui.MainActivity
com.google.android.apps.privacy.wildlife	.settings.settingsui.MainSettingsActivity
com.google.android.apps.recorder	.ui.recordings.MainActivity
com.google.android.apps.restore	com.google.android.apps.pixelmigrate.component.StubLauncherActivity
com.google.android.apps.safetyhub	.LauncherActivity
com.google.android.apps.subscriptions.red	.LauncherActivity
com.google.android.apps.tachyon	.ui.launcher.AtvLauncherActivity
com.google.android.apps.tasks	.ui.TaskListsActivity
com.google.android.apps.tips	.TipsMain
com.google.android.apps.translate	.TranslateActivity
com.google.android.apps.walletnfcrel	com.google.commerce.tapandpay.android.wallet.WalletActivity
com.google.android.apps.wearables.maestro.companion	.ui.init.InitNavigationActivity
com.google.android.apps.weather	.home.HomeActivity
com.google.android.apps.wellbeing	.winddown.ui.WindDownEntryActivity
com.google.android.apps.work.clouddpc	.base.managedprovisioning.preprovisioning.PostEncryptionActivity
com.google.android.apps.youtube.music	.activities.MusicActivity
com.google.android.as.oss	com.google.android.apps.miphone.astrea.feedback.FeedbackActivity
com.google.android.as	com.google.android.apps.miphone.aiai.adaptiveaudio.setupwizard.AdaptiveFeaturesSetupWizardActivity
com.google.android.calculator	com.android.calculator2.Calculator
com.google.android.calendar	com.android.calendar.AllInOneActivity
com.google.android.contacts	com.android.contacts.activities.PeopleActivity
com.google.android.deskclock	com.android.deskclock.DeskClock
com.google.android.dialer	com.android.dialer.main.impl.MainActivity
com.google.android.documentsui	com.android.documentsui.LauncherActivity
com.google.android.gm	.setup.AccountSetupFinalGmail
com.google.android.gms	.auth.uiflows.addaccount.AccountIntroActivity
com.google.android.googlequicksearchbox	com.google.android.apps.gsa.staticplugins.opa.setupwizard.SetupWizardActivity
com.google.android.googlequicksearchbox	com.google.android.apps.gsa.staticplugins.gearhead.projected.VoicePlateCarService
com.google.android.inputmethod.latin	com.google.android.libraries.inputmethod.launcher.LauncherActivity
com.google.android.keep	.activities.BrowseActivity
com.google.android.marvin.talkback	com.google.android.accessibility.talkback.preference.GestureChangeNotificationActivity
com.google.android.music	.tombstone.LauncherActivity
com.google.android.play.games	com.google.android.apps.play.games.features.gamefolder.appdrawer.GameFolderAppDrawerActivity
com.google.android.projection.gearhead	.frx.SetupActivity
com.google.android.projection.gearhead	.setup.SetupService
com.google.android.settings.intelligence	.modules.suggestions.NightlightTrampolineActivity
com.google.android.videos	.activity.LauncherActivity
com.google.android.youtube	com.google.android.apps.youtube.app.application.Shell_SettingsActivity
com.google.ar.lens	com.google.vr.apps.ornament.app.lens.LensLauncherActivity
com.google.audio.hearing.visualization.accessibility.scribe	.MainActivity
com.hulu.plus	com.hulu.features.splash.SplashActivity
com.imdb.mobile	.HomeActivity
com.instacart.client	.browse.ICBrowseActivity
com.isonas.puremobile	.ui.MainActivity
com.jefftharris.passwdsafe	.FileListActivity
com.joetech.tvremote	.MainActivity
com.kayak.android	.splash.SplashActivity
com.kingsoopers.mobile	com.kroger.mobile.BannerSelectionActivity
com.kingsoopers.mobile	com.qualtrics.digital.QualtricsNotificationManager
com.linkedin.android	.authenticator.DiwaliActivityAlias
com.linkedin.android	com.qualtrics.digital.QualtricsNotificationManager
com.mapollc.mapofire	.SyncActivity
com.media.bestrecorder.audiorecorder	.NavigationActivity
com.microsoft.amp.apps.bingnews	com.microsoft.sapphire.app.main.SapphireMainActivity
com.microsoft.appmanager	.StartUpActivity
com.microsoft.launcher	.LauncherActivity
com.microsoft.office.excel	.excelMainActivity
com.microsoft.office.officehubrow	com.microsoft.office.officesuite.OfficeSuiteActivity
com.microsoft.office.onenote	.ui.ONMSplashActivity
com.microsoft.office.outlook	.MainActivity
com.microsoft.office.word	.WordActivity
com.microsoft.skydrive	.MainActivity
com.mobile.uhc	.SplashActivity
com.mobile.uhc	com.qualtrics.digital.QualtricsNotificationManager
com.monarchmoney.mobile	.MainActivity
com.morganstanley.clientmobile.prod	com.morganstanley.mscordova.shim.MSShimActivity
com.nclh.ncl_mobile	.MainActivity
com.nytimes.android	.MainActivity
com.nytimes.cooking	.SplashScreenActivity
com.nytimes.crossword	com.nytimes.games.core.activity.MainActivity
com.omronhealthcare.omronconnect	com.omronhealthcare.foresight.view.module.splash.SplashActivity
com.onepeloton.callisto	.MainActivity
com.openai.chatgpt	.MainActivity
com.opentable	.activities.search.SearchResults
com.optum.rx	.SplashActivity
com.optum.rx	com.qualtrics.digital.QualtricsNotificationManager
com.parcelpendingmobile.app	.MainActivity
com.pbs.video	.StartupActivity
com.podcast.podcasts	fm.castbox.ui.main.MainActivity
com.purplecover.anylist	.ui.LaunchActivity
com.resmed.myair	com.resmed.mon.presentation.workflow.authentication.launch.LaunchActivity
com.rfit.glycemicindextracker	.MainActivity
com.rhmsoft.edit.pro	com.rhmsoft.edit.activity.MainActivity
com.shazam.android	.activities.SplashActivity
com.sillens.shapeupclub	com.lifesum.android.main.MainActivity
com.socialnmobile.dictapps.notepad.color.note	com.socialnmobile.colornote.activity.Main
com.southwestairlines.mobile	.common.splash.SplashActivity
com.southwestairlines.mobile	com.qualtrics.digital.QualtricsNotificationManager
com.sportclips.ultimatemvp	.MainActivity
com.spotify.music	.SpotifyMainActivity
com.toddkushnerllc.android_adaptive_ui	.MainActivity
com.toddkushnerllc.android_binary_counting_app	.MainActivity
com.toddkushnerllc.android_count_app	.MainActivity
com.toddkushnerllc.android_organizer_project_app	.MainActivity
com.toddkushnerllc.com.android_pointer_demo	.MainActivity
com.toyota.oneapp	.ui.splash.SplashActivity
com.tplink.tether	.WelcomeActivity
com.treemolabs.apps.cbsnews	.ui.activities.StartActivity
com.treemolabs.apps.cbsnews	com.qualtrics.digital.QualtricsNotificationManager
com.ubercab	.presidio.app.core.root.RootActivity
com.uchealth.mobile	.activities.SplashActivity
com.united.mobile.android	.ui.splash.SplashActivity
com.united.mobile.android	com.qualtrics.digital.QualtricsNotificationManager
com.ups.mobile.android	.MainActivity
com.ups.mobile.android	com.qualtrics.digital.QualtricsNotificationManager
com.vcast.mediamanager	.gui.activities.SplashLogoActivity
com.venmo	.android.platform.AppExperienceLauncherActivity
com.verizon.messaging.vzmsgs	com.verizon.mms.ui.activity.Provisioning
com.verizon.messaging.vzmsgs	.ux.conversation.activity.ConversationListActivity
com.vrbo.android	com.expedia.bookings.activity.SearchActivity
com.vrbo.android	com.qualtrics.digital.QualtricsNotificationManager
com.vzw.hss.myverizon	com.vzw.mobilefirst.setup.views.activity.SetUpActivity
com.vzw.hss.myverizon	com.qualtrics.digital.QualtricsNotificationManager
com.wbd.stream	com.wbd.fuse.appcore.FuseActivity
com.withings.wiscale2	.MainActivity
com.yelp.android	.home.ui.RootSingleActivity
com.zillow.android.zillowmap	com.zillow.android.splashscreen.SplashScreenActivity
cz.ackee.ventusky	.screens.main.MainActivity
cz.hipercalc.pro	app.hipercalc.CalculatorActivity
gov.dhs.tsa.mytsa	gov.dhs.mytsa.ui.splash.SplashActivity
jbl.stc.com	.activity.LauncherStartActivity
me.lyft.android	.ui.MainActivity
me.proton.android.drive	.ui.MainActivity
net.mullvad.mullvadvpn	.ui.MainActivity
net.sharewire.parkmobilev2	net.easypark.android.mvp.splash.SplashActivity
nz.co.vista.android.movie.metrotheatres	com.webedia.optimusprime.ui.splash.SplashActivity
org.chromium.webapk.a2eec8d03c8dc3c83_v2	org.chromium.webapk.shell_apk.h2o.H2OOpaqueMainActivity
org.chromium.webapk.a2eec8d03c8dc3c83_v2	org.chromium.webapk.shell_apk.WebApkServiceFactory
org.chromium.webapk.a3716aefdfcfcffc6_v2	org.chromium.webapk.shell_apk.h2o.H2OOpaqueMainActivity
org.chromium.webapk.a3716aefdfcfcffc6_v2	org.chromium.webapk.shell_apk.WebApkServiceFactory
org.chromium.webapk.a86124622c4ab0876_v2	org.chromium.webapk.shell_apk.h2o.H2OOpaqueMainActivity
org.chromium.webapk.a86124622c4ab0876_v2	org.chromium.webapk.shell_apk.WebApkServiceFactory
org.chromium.webapk.a899dfd78ed5530b3_v2	org.chromium.webapk.shell_apk.h2o.H2OOpaqueMainActivity
org.chromium.webapk.a899dfd78ed5530b3_v2	org.chromium.webapk.shell_apk.WebApkServiceFactory
org.chromium.webapk.ae8b3ec22556f0d4f_v2	org.chromium.webapk.shell_apk.h2o.H2OOpaqueMainActivity
org.chromium.webapk.ae8b3ec22556f0d4f_v2	org.chromium.webapk.shell_apk.WebApkServiceFactory
org.chromium.webapk.afe8cbaf49d810464_v2	org.chromium.webapk.shell_apk.h2o.H2OOpaqueMainActivity
org.chromium.webapk.afe8cbaf49d810464_v2	org.chromium.webapk.shell_apk.WebApkServiceFactory
org.jitsi.meet	.MainActivity
org.npr.android.news	org.npr.one.StartActivity
org.videolan.vlc	.StartActivity
org.wikipedia	.main.MainActivity
photo.editor.photoeditor.photoeditorpro	com.camerasideas.collagemaker.activity.DummyActivity
tool.audio.cutter.ringtonemaker	com.ijoysoft.ringtone.activity.WelcomeActivity
tv.remote.control.sonytv	.MainActivity
tv.standard.nebula	.main.view.activities.MainActivity
us.zoom.videomeetings	com.zipow.videobox.LauncherActivity
