bbc.mobile.news.ww	com.mobile.MainActivity
bitpit.launcher	bitpit.launcher.ui.HomeActivity
ch.protonmail.android	ch.protonmail.android.MainActivity
chipolo.net.v3	net.chipolo.app.ui.main.MainActivity
com.Splitwise.SplitwiseMobile	com.Splitwise.SplitwiseMobile.views.SplitwiseSplashScreen
com.aaa.android.discounts	com.aaa.android.discounts.MainActivity
com.abc.abcnews	com.abc.abcnews/com.disney.bootstrap.activity.bootstrap.BootstrapActivity
com.adobe.lrmobile	com.adobe.lrmobile.StorageCheckActivity
com.adobe.reader	com.adobe.reader.AdobeReader
com.alphainventor.filemanager	com.alphainventor.filemanager.activity.MainActivity
com.amazon.avod.thirdpartyclient	com.amazon.avod.client.activity.SplashScreenActivity
com.amazon.dee.app	com.amazon.dee.app.Launcher
com.amazon.kindle	com.amazon.kindle.UpgradePage
com.amazon.mShop.android.shopping	com.amazon.mShop.home.HomeActivity
com.americanexpress.android.acctsvcs.us	com.americanexpress.android.acctsvcs.us.firstuse.StartupActivity
com.audible.application	com.audible.application/androidx.test.core.app.InstrumentationActivityInvoker$BootstrapActivity
com.azure.authenticator	com.azure.authenticator.ui.LaunchActivity
com.basiletti.gino.offlinenotepad	com.basiletti.gino.offlinenotepad.ui.main.DashboardActivity
com.bose.bosemusic	com.bose.madrid.SplashScreenActivity
com.britbox.us	com.britbox.us.MainActivity
com.cbs.app	com.paramount.android.pplus.features.splash.mobile.integration.SplashActivity
com.chase.sig.android	com.chase.sig.android.activity.SplashActivity
com.chess.splash.SplashActivit	
com.citi.mobile.pt3.GlobalPhoneActivit	
com.cnn.mobile.android.phone.features.splash.SplashActivit	
com.cookunity.android.app.ui.activity.InitActivit	
com.costco.app.android.ui.main.MainActivit	
com.curiosity.curiositystream.MainActivit	
com.dashlane.ui.activities.SplashScreenActivit	
com.daugherty.nws_remastered.MainActivit	
com.delta.mobile.android.SplashScree	
com.digitalpharmacist.rxpharmacy.SplashActivit	
com.discord.main.MainDefaul	
com.disney.disneyplus/com.bamtechmedia.dominguez.main.MainActivit	
com.dropbox.android.activity.DropboxBrowse	
com.etatransit.activity.SplashActivit	
com.etekcity.vesyncplatform.presentation.ui.activities.LaunchActivit	
com.expedia.bookings.activity.SearchActivit	
com.fedex.ida.android.views.core.FedExHOM	
com.fitbit.FirstActivit	
com.geico.mobile.android.ace.geicoapppresentation.splash.mvvm.view.AceSplashActivit	
com.github.android.main.MainActivit	
com.google.android.apps.access.wifi.consumer.app.MainActivit	
com.google.android.apps.accessibility.magnifier.home.HomeActivit	
com.google.android.apps.adm.activities.MainActivit	
com.google.android.apps.authenticator2.main.MainActivit	
com.google.android.apps.bard.shellapp.BardEntryPointActivit	
com.google.android.apps.books.app.BooksActivit	
com.google.android.apps.chromecast.app.DiscoveryActivit	
com.google.android.apps.cloudconsole.common.ExternalMainContainerActivit	
com.google.android.apps.docs.app.NewMainProxyActivit	
com.google.android.apps.docs.app.NewMainProxyActivit	
com.google.android.apps.docs.app.NewMainProxyActivit	
com.google.android.apps.dynamite.startup.StartUpActivit	
com.google.android.apps.healthdat	
com.google.android.apps.helprt	
com.google.apps.dots.android.app.activity.CurrentsStartActivit	
com.google.android.apps.subscriptions.red.LauncherActivit	
com.google.android.apps.tasks.ui.TaskListsActivit	
com.google.android.apps.translate.TranslateActivit	
com.google.commerce.tapandpay.android.wallet.WalletActivit	
com.google.android.im	
com.google.android.keep.activities.BrowseActivity	com.google.android.music
com.google.android.music.tombstone.LauncherActivity	com.google.android.play.games
com.google.android.apps.play.games.features.gamefolder.appdrawer.GameFolderAppDrawerActivity	com.google.android.safetycore
com.google.ar.lens	com.google.vr.apps.ornament.app.lens.LensLauncherActivity
com.hulu.plus	com.hulu.features.splash.SplashActivity
com.imdb.mobile	com.imdb.mobile.HomeActivity
com.instacart.client	com.instacart.client.browse.ICBrowseActivity
com.isonas.puremobile	com.isonas.puremobile.ui.MainActivity
com.jefftharris.passwdsafe	com.jefftharris.passwdsafe.FileListActivity
com.joetech.tvremote	com.joetech.tvremote.MainActivity
com.kayak.android	com.kayak.android.splash.SplashActivity
com.kingsoopers.mobile	com.kroger.mobile.BannerSelectionActivity
com.linkedin.android	com.linkedin.android.authenticator.DiwaliActivityAlias
com.mapollc.mapofire	com.mapollc.mapofire.SyncActivity
com.media.bestrecorder.audiorecorder	com.media.bestrecorder.audiorecorder.NavigationActivity
com.microsoft.amp.apps.bingnews	com.microsoft.sapphire.app.main.SapphireMainActivity
com.microsoft.appmanager	com.microsoft.appmanager.StartUpActivity
com.microsoft.launcher	com.microsoft.launcher.LauncherActivity
com.microsoft.office.excel	com.microsoft.office.excel.excelMainActivity
com.microsoft.office.officehubrow	com.microsoft.office.officesuite.OfficeSuiteActivity
com.microsoft.office.onenote	com.microsoft.office.onenote.ui.ONMSplashActivity
com.microsoft.office.outlook	com.microsoft.office.outlook.MainActivity
com.microsoft.office.word	com.microsoft.office.word.WordActivity
com.microsoft.skydrive	com.microsoft.skydrive.MainActivity
com.mobile.uhc	com.mobile.uhc.SplashActivity
com.monarchmoney.mobile	com.monarchmoney.mobile.MainActivity
com.morganstanley.clientmobile.prod	com.morganstanley.mscordova.shim.MSShimActivity
com.nclh.ncl_mobile	com.nclh.ncl_mobile.MainActivity
com.nytimes.android	com.nytimes.android.MainActivity
com.nytimes.cooking	com.nytimes.cooking.SplashScreenActivity
com.nytimes.crossword	com.nytimes.games.core.activity.MainActivity
com.omronhealthcare.omronconnect	com.omronhealthcare.foresight.view.module.splash.SplashActivity
com.onepeloton.callisto	com.onepeloton.callisto.MainActivity
com.openai.chatgpt	com.openai.chatgpt.MainActivity
com.opentable	com.opentable.activities.search.SearchResults
com.optum.rx	com.optum.rx.SplashActivity
com.parcelpendingmobile.app	com.parcelpendingmobile.app.MainActivity
com.pbs.video	com.pbs.video.StartupActivity
com.podcast.podcasts	fm.castbox.ui.main.MainActivity
com.purplecover.anylist	com.purplecover.anylist.ui.LaunchActivity
com.resmed.myair	com.resmed.mon.presentation.workflow.authentication.launch.LaunchActivity
com.rfit.glycemicindextracker	com.rfit.glycemicindextracker.MainActivity
com.rhmsoft.edit.pro	com.rhmsoft.edit.activity.MainActivity
com.shazam.android	com.shazam.android.activities.SplashActivity
com.sillens.shapeupclub	com.lifesum.android.main.MainActivity
com.socialnmobile.dictapps.notepad.color.note	com.socialnmobile.colornote.activity.Main
com.southwestairlines.mobile	com.southwestairlines.mobile.common.splash.SplashActivity
com.sportclips.ultimatemvp	com.sportclips.ultimatemvp.MainActivity
com.spotify.music	com.spotify.music.SpotifyMainActivity
com.toyota.oneapp	com.toyota.oneapp.ui.splash.SplashActivity
com.tplink.tether	com.tplink.tether.WelcomeActivity
com.treemolabs.apps.cbsnews	com.treemolabs.apps.cbsnews.ui.activities.StartActivity
com.ubercab	com.ubercab.presidio.app.core.root.RootActivity
com.uchealth.mobile	com.uchealth.mobile.activities.SplashActivity
com.united.mobile.android	com.united.mobile.android.ui.splash.SplashActivity
com.ups.mobile.android	com.ups.mobile.android.MainActivity
com.vcast.mediamanager	com.vcast.mediamanager.gui.activities.SplashLogoActivity
com.veho.consumermobile	com.veho.consumermobile.MainActivity
com.venmo	com.venmo.android.platform.AppExperienceLauncherActivity
com.verizon.messaging.vzmsgs	com.verizon.mms.ui.activity.Provisioning
com.vrbo.android	com.expedia.bookings.activity.SearchActivity
com.vzw.hss.myverizon	com.vzw.mobilefirst.setup.views.activity.SetUpActivity
com.wbd.stream	com.wbd.fuse.appcore.FuseActivity
com.withings.wiscale2	com.withings.wiscale2.MainActivity
com.yelp.android	com.yelp.android.home.ui.RootSingleActivity
com.zillow.android.zillowmap	com.zillow.android.splashscreen.SplashScreenActivity
cz.ackee.ventusky	cz.ackee.ventusky.screens.main.MainActivity
cz.hipercalc.pro	app.hipercalc.CalculatorActivity
gov.dhs.tsa.mytsa	gov.dhs.mytsa.ui.splash.SplashActivity
jbl.stc.com	jbl.stc.com.activity.LauncherStartActivity
me.lyft.android	me.lyft.android.ui.MainActivity
me.proton.android.drive	me.proton.android.drive.ui.MainActivity
net.mullvad.mullvadvpn	net.mullvad.mullvadvpn.ui.MainActivity
net.sharewire.parkmobilev2	net.easypark.android.mvp.splash.SplashActivity
nz.co.vista.android.movie.metrotheatres	com.webedia.optimusprime.ui.splash.SplashActivity
org.jitsi.meet	org.jitsi.meet.MainActivity
org.npr.android.news	org.npr.one.StartActivity
org.videolan.vlc	org.videolan.vlc.StartActivity
org.wikipedia	org.wikipedia.main.MainActivity
photo.editor.photoeditor.photoeditorpro	com.camerasideas.collagemaker.activity.DummyActivity
tool.audio.cutter.ringtonemaker	com.ijoysoft.ringtone.activity.WelcomeActivity
tv.remote.control.sonytv	tv.remote.control.sonytv.MainActivity
tv.standard.nebula	tv.standard.nebula.main.view.activities.MainActivity
us.zoom.videomeetings	com.zipow.videobox.LauncherActivity
